5 0 0 0 0 0 0 0 0 0 0 0 0 0 5
0 1 1 1 1 1 1 2 1 1 1 1 1 1 0
0 1 4 2 0 0 0 0 0 0 0 2 3 1 0
0 1 2 1 0 0 0 0 0 0 0 1 2 1 0
0 1 0 0 0 0 0 0 0 0 0 0 0 1 0
0 1 0 0 0 0 0 0 0 0 0 0 0 1 0
0 1 0 0 0 0 0 0 0 0 0 0 0 1 0
0 2 0 0 0 0 0 1 0 0 0 0 0 2 0
0 1 0 0 0 0 0 0 0 0 0 0 0 1 0
0 1 0 0 0 0 0 0 0 0 0 0 0 1 0
0 1 0 0 0 0 0 0 0 0 0 0 0 1 0
0 1 2 1 0 0 0 0 0 0 0 1 2 1 0
0 1 3 2 0 0 0 0 0 0 0 2 4 1 0
0 1 1 1 1 1 1 2 1 1 1 1 1 1 0
5 0 0 0 0 0 0 0 0 0 0 0 0 0 5