2 0 0 0 0 0 0 5 0 0 0 0 0 0 2 
0 1 2 1 2 1 3 4 3 1 2 1 2 1 0 
0 2 0 2 0 2 2 2 2 2 0 2 0 2 0 
0 1 2 4 2 1 0 3 0 1 2 4 2 1 0 
0 2 0 2 3 0 2 0 2 0 3 2 0 2 0 
0 1 2 1 0 1 4 2 4 1 0 1 2 1 0 
0 3 2 0 2 4 1 3 1 4 2 0 2 3 0 
5 4 2 3 0 2 3 0 3 2 0 3 2 4 5 
0 3 2 0 2 4 1 3 1 4 2 0 2 3 0 
0 1 2 1 0 1 4 2 4 1 0 1 2 1 0 
0 2 0 2 3 0 2 0 2 0 3 2 0 2 0 
0 1 2 4 2 1 0 3 0 1 2 4 2 1 0 
0 2 0 2 0 2 2 2 2 2 0 2 0 2 0 
0 1 2 1 2 1 3 4 3 1 2 1 2 1 0 
2 0 0 0 0 0 0 5 0 0 0 0 0 0 2 
